___________________________________________________________________________________________________
|                                                                                                  |
|~~~~~~~~~~~~~~~~~~~~~~~~~~~~~~~~~~~~~~~~~~~~~~~~~~~~~~~~~~~~~~~~~~~~~~~~~~~~~~~~~~~~~~~~~~~~~~~~~~|
|                     *                                                  *                         |
|                                                                                                  |
|                                              *                                                   |
|                                                                                                  |
|                                                                *                                 |
|             *                                                                                    |
|                                        *                                                         |
|                                                                                                  |
|                        *                                                                         |
|                                                                                                  |
|  *                                                                                               |
|                                                                                                  l
|                                      *                                                           |
|                                                                 *                                |
|           *                                                                                      |
|                                                                                                  |
|                                               *                                                  |
|                                                                                                  |
|                                                                                         *        |
|                               *                                                                  |
|            *                                                                                     |
|                                                               *                                  |
|                                                                                                  |
|                                                                                                  |
|__________________________________________________________________________________________________|


